A Better Future Through Science _ StarTalk-0SnZyZzclWY.en.srt	animals
Adorable Bear Cubs Crash Campsite _ Expedition Raw-LbX_AUgtyQc.en.srt	animals
Adorable Googly-Eyed Sea Creature Puzzles Scientists-lLKaXshILBY.en.srt	science
A Food Thief in the Night _ Primal Survivor-2QwHTwVqC0k.en.srt	others
A Grave Threat _ Cosmos - A Spacetime Odyssey-QvHQnWFWnIg.en.srt	others
A Losing Battle _ Live Free or Die-mHD6wHxyV2M.en.srt	science
Altered States _ Brain Games-80x-uq8iy_k.en.srt	sports
Amazing Drone Footage of Nubian Pyramids _ Expedition Raw-O7tAuPi_azU.en.srt	science
Amelia's Turkey Tail Tea _ Live Free or Die - How to Homestead-spoTAuuXus4.en.srt	geography
An Argument Against Memorization _ StarTalk-ouMvHMBAMWo.en.srt	art
Angel Bees vs. Robber Bees _ National Geographic-jow7qihesxg.en.srt	art
A Primitive Squirrel Hunt _ Live Free or Die-K-UYliL26eU.en.srt	art
Are There White Holes - Fan Questions _ StarTalk-bN8F0QKsCdY.en.srt	science
Arianna Huffington on Meditation _ StarTalk-3ZvNYIrJgEY.en.srt	others
Artificial Intelligence in Space _ StarTalk-HJNNU2eR2oc.en.srt	science
Assassin Bug vs. Vampire Bat _ National Geographic-F1or77Rf5VQ.en.srt	science
A Steam Pit Celebration _ Live Free or Die-3XjfjxAnHmI.en.srt	art
A Wicked Tongue _ Wicked Tuna-9HYDawu8urU.en.srt	people
Baby Making On Mars _ StarTalk-LbkuiWI3Mrc.en.srt	science
Baby Owl vs. Hawk Moth _ National Geographic-Cd8XuPBp9Jo.en.srt	others
Badass Women Battle Untamed Mongolian River _ Expedition Raw-hTI8idwjkgw.en.srt	people
Bandicoot Rat vs. Croc and Python _ National Geographic-6iroFKgekcI.en.srt	science
Bat Man of Borneo _ Expedition Raw-pbJ8MXDOK7U.en.srt	others
Bear vs. Gorilla - Fan Questions _ StarTalk-2Ttjbb5anok.en.srt	science
Beaver for Bolts _ Live Free or Die-wBgmyZRPvLY.en.srt	art
Bee vs. Jumping Spider _ National Geographic-Mew3eK0Wuvk.en.srt	geography
Before 'Black Lives Matter' - A 1959 Speech About Police Brutality _ National Geographic-gKmf6eOQrLI.en.srt	science
Before the Flood - Trailer _ National Geographic-D9xFFyUOpXo.en.srt	art
Bill Nye and Exploration _ StarTalk-xXQHyTTcMR4.en.srt	people
Bill Nye on Preventing Disease _ StarTalk-S4m_7XaLwes.en.srt	science
Bill Nye on Social Media _ StarTalk-M4YLIX5BaaU.en.srt	others
Bill Nye on Space Exploration _ StarTalk-2QgWj1iDg18.en.srt	science
Bill Nye on TV History _ StarTalk-rBmw03SHY70.en.srt	science
Billon Bares All _ Wicked Tuna - Outer Banks-U7BkGllfc7g.en.srt	science
Black Holes Blazars and Women of Color in Science - Nat Geo Live-NBRrcSkK6iE.en.srt	science
Blacksmith for Barter _ Live Free or Die-cEmPo6SG1xc.en.srt	others
Boat Tour - Reel Action _ Wicked Tuna - Outer Banks-NIZgfc1bYdE.en.srt	animals
Boat Tour - Reels of Fortune _ Wicked Tuna - Outer Banks-73lkxIZWvJE.en.srt	art
Boomslang vs. Chameleon _ National Geographic-4aIIopjs_iw.en.srt	transportation
Building a Blind _ Live Free or Die-4KPIts02Tuo.en.srt	science
Building a Bundle Boat _ Live Free or Die-fZMd0en0uu4.en.srt	others
Building Shelter _ How to Survive on Mars-A3crw903HU0.en.srt	art
Camp for the Night _ Live Free or Die-42C6AwRLhEg.en.srt	others
Can Air Be A Water Source During A Drought-OX9m-_wSAIM.en.srt	art
Cannibal Scorpions vs. Shrew _ National Geographic-WKDsULG_FPE.en.srt	art
Can Opera Singers Shatter Glass _ StarTalk-9p26ltGlPtg.en.srt	science
Can Wild Monkeys Hang With Humans _ Expedition Raw-oqgFHBtNb64.en.srt	others
Capturing the Beauty of Africaâ€™s Wildlife and Fighting to Save It-6bgBRLWdaVQ.en.srt	science
Capuchin Monkey Soap Opera in Costa Rica _ Expedition Raw-SYWURlcQ8cI.en.srt	others
Caribou Blanket _ Life Below Zero-qjHQB79FkGg.en.srt	animals
